126 126 126 126 126 126 126 126 126 126 126 126 126
126 43 43 43 43 43 43 43 43 43 43 43 126
126 43 48 48 48 48 48 48 48 48 48 43 126
126 43 48 48 48 48 48 48 48 80 48 43 126 
126 43 48 48 48 48 48 48 48 48 48 43 126
126 43 48 48 48 48 48 48 48 48 48 43 126
126 43 48 48 48 48 48 48 48 48 48 43 126
126 43 43 43 43 43 43 43 43 43 43 43 126
126 126 126 126 126 126 126 126 126 126 126 126 126