126 126 126 126 126 126 126 126 126 126 126 126 126 126 126 126 126 126 126 126 126 126 126 126 126 126 126 126 126 126 126 126 126 126 126 126 126 126 126 126 126 126 126 126 126 126 126 126 126 126 
126 14 14 14 14 14 14 14 14 14 14 14 14 14 14 14 14 14 14 14 14 14 14 14 14 14 14 14 14 14 14 14 14 14 14 14 14 14 14 14 14 14 14 14 14 14 14 14 14 126 
126 14 14 14 14 14 14 14 14 14 14 14 14 14 14 14 14 14 14 14 14 14 14 14 14 14 14 14 14 14 14 14 14 14 14 14 14 14 14 14 14 14 14 14 14 14 14 14 14 126 
126 14 14 14 14 14 14 14 14 14 14 14 14 14 14 14 14 14 14 14 14 14 14 14 14 14 14 14 14 14 14 14 14 14 14 14 14 14 14 14 14 14 14 14 14 14 14 14 14 126 
126 14 14 14 14 14 14 14 16 16 16 16 16 14 16 16 16 16 16 16 16 16 16 16 16 16 16 16 16 16 16 16 16 16 16 16 16 16 16 16 16 16 16 14 14 14 14 14 14 126 
126 14 14 14 14 14 16 15 15 15 15 15 14 14 16 16 16 16 16 16 16 16 16 15 15 15 15 15 15 15 15 16 16 16 16 16 16 16 16 16 16 16 16 16 14 14 14 14 14 126 
126 14 14 14 14 16 15 15 16 16 14 14 14 14 16 16 16 16 16 16 16 15 15 15 16 16 16 16 16 16 16 16 16 16 16 16 16 16 16 16 16 14 14 14 14 14 14 14 14 126 
126 14 14 14 14 16 15 15 16 14 14 14 14 16 16 16 16 15 15 14 14 16 16 16 16 16 16 16 16 16 16 15 15 15 15 16 15 15 15 14 14 14 14 16 16 14 14 14 14 126 
126 14 14 14 14 16 16 15 15 14 14 14 16 16 16 16 16 15 15 14 14 14 14 16 16 16 16 16 15 16 15 15 15 16 16 16 15 15 16 14 14 14 15 15 16 16 14 14 14 126 
126 14 14 14 16 16 16 15 14 14 14 16 15 16 16 16 16 16 16 14 14 14 14 14 15 16 16 16 16 16 16 15 15 16 15 15 15 16 14 14 14 16 16 15 16 16 14 14 14 126 
126 14 14 14 16 16 16 15 14 14 14 15 16 16 16 16 16 16 16 15 14 14 14 14 14 16 16 16 16 15 16 16 15 16 16 16 16 14 14 14 14 16 16 15 16 16 14 14 14 126 
126 14 14 14 16 16 16 15 14 14 16 15 16 16 15 15 16 16 16 15 16 14 14 14 14 14 15 16 16 15 16 15 15 16 16 16 16 14 14 14 16 16 15 15 16 16 14 14 14 126 
126 14 14 14 16 16 16 15 14 14 15 16 16 16 16 15 16 16 16 15 16 14 14 14 14 14 14 15 15 15 15 15 15 16 16 16 16 14 14 14 16 15 15 16 16 16 14 14 14 126 
126 14 14 14 16 16 16 16 14 14 16 16 16 15 15 15 16 16 15 14 14 14 14 14 14 14 14 14 15 15 15 15 16 16 16 16 16 14 14 16 15 15 16 16 16 16 14 14 14 126 
126 14 14 14 16 16 16 16 16 16 16 15 15 15 15 15 16 16 16 16 15 15 16 16 16 14 14 14 14 15 15 16 16 16 16 16 16 14 14 16 16 15 16 16 16 16 14 14 14 126 
126 14 14 14 16 16 16 16 16 16 16 15 15 15 15 15 15 15 16 16 16 15 15 16 16 15 16 14 14 15 15 15 16 16 16 16 16 14 14 16 16 16 16 16 16 16 14 14 14 126 
126 14 14 14 16 16 16 16 16 15 15 15 15 16 16 15 16 15 16 16 16 16 15 15 16 15 16 16 16 16 16 15 15 15 15 16 16 15 15 16 16 16 16 16 16 16 14 14 14 126 
126 14 14 14 16 16 16 16 16 15 15 15 15 15 16 15 16 15 14 14 16 16 16 16 16 15 15 15 15 15 16 16 16 16 16 15 15 15 15 15 16 16 16 15 16 16 14 14 14 126 
126 14 14 14 16 16 16 16 14 14 16 14 16 15 16 16 15 16 14 14 14 16 16 16 16 15 15 15 14 14 14 16 16 15 15 15 16 16 16 15 16 16 15 15 16 16 14 14 14 126 
126 14 14 14 16 16 16 16 14 14 16 14 14 15 15 16 15 15 15 14 14 14 16 16 15 15 15 14 14 14 14 14 15 15 15 15 16 16 16 16 16 16 15 16 16 16 14 14 14 126 
126 14 14 14 16 16 16 15 16 14 14 14 14 14 16 15 16 15 15 16 14 16 15 15 16 16 16 14 14 14 14 14 16 15 15 15 15 16 16 16 16 14 15 16 16 16 14 14 14 126 
126 14 14 14 16 16 16 15 16 14 14 14 16 14 16 15 16 16 15 16 14 16 15 16 16 16 16 14 14 14 14 14 15 15 15 15 15 16 16 16 14 14 15 15 16 16 14 14 14 126 
126 14 14 14 16 16 16 15 15 15 14 14 14 14 14 16 15 15 15 15 15 16 16 16 16 16 15 14 14 14 14 14 15 15 16 15 15 16 16 15 14 14 15 16 16 16 14 14 14 126 
126 14 14 14 16 16 16 15 15 16 14 14 14 14 14 14 16 16 15 15 15 16 16 16 16 16 16 14 14 14 14 14 15 15 16 16 15 16 15 15 14 15 15 16 16 16 14 14 14 126 
126 14 14 14 15 15 15 15 15 15 15 14 14 14 14 14 14 14 15 15 16 16 16 16 16 16 15 14 14 14 14 15 15 16 16 16 15 16 15 16 16 15 15 16 16 16 14 14 14 126 
126 14 14 14 15 15 15 15 15 16 16 14 15 14 14 14 14 14 14 14 14 16 16 15 15 16 14 14 14 14 15 16 15 16 16 16 16 16 16 16 16 15 15 16 16 16 14 14 127 126 
126 14 14 14 16 16 15 15 15 15 16 16 15 14 14 14 14 14 14 14 15 16 15 15 15 15 14 14 14 14 16 16 16 16 16 16 15 15 16 16 16 15 15 16 16 16 14 127 128 126 
126 14 14 14 16 16 15 15 15 16 16 16 16 14 14 14 14 14 14 16 15 16 16 16 15 15 15 14 14 14 14 15 15 16 16 16 15 15 15 15 16 15 15 16 16 16 31 32 32 126 
126 14 14 14 16 16 15 15 16 16 16 16 16 14 14 14 14 14 16 16 15 16 16 16 15 16 16 14 14 14 14 14 15 15 16 15 16 15 15 15 15 15 15 16 16 16 38 39 39 126 
126 14 14 14 16 16 16 15 15 15 16 16 16 14 14 14 14 16 16 16 16 15 16 16 15 15 15 15 14 14 14 14 14 16 16 16 15 16 15 15 15 15 15 16 16 16 14 127 128 126 
126 14 14 14 16 16 16 15 16 15 16 15 14 14 14 16 16 16 16 16 15 15 14 16 16 16 15 15 16 14 14 14 14 14 14 16 16 15 16 16 15 15 15 16 16 14 14 14 128 126 
126 14 14 14 16 16 16 15 15 16 15 15 14 14 14 14 16 16 16 15 16 15 14 14 15 16 15 16 16 15 14 14 14 14 14 14 14 14 16 16 16 16 16 16 14 14 14 14 14 126 
126 14 14 14 16 16 16 16 15 15 15 15 14 14 14 15 16 16 16 16 16 14 14 14 16 15 16 16 15 15 16 14 14 14 14 14 14 14 14 14 16 14 14 14 14 14 14 14 14 126 
126 14 14 14 16 16 16 16 16 16 16 15 14 14 16 16 16 16 16 16 16 15 16 16 15 16 16 16 15 15 15 16 16 16 16 14 14 14 14 14 14 14 14 14 14 14 14 14 14 126 
126 14 14 14 16 16 16 16 16 16 16 16 14 14 16 16 16 16 16 16 16 16 16 16 16 16 16 16 16 16 16 16 16 16 16 16 14 14 14 14 14 14 14 14 14 15 14 14 14 126 
126 14 14 14 16 16 16 16 16 16 15 16 14 14 16 16 15 16 16 16 15 16 16 16 16 16 16 16 16 15 16 16 16 16 16 15 16 14 14 14 14 14 14 16 16 15 14 14 14 126 
126 14 14 14 16 16 16 16 16 15 16 17 16 16 16 16 16 16 16 16 15 15 15 15 15 15 16 16 15 15 15 15 16 16 16 16 16 16 15 15 16 15 16 16 15 15 14 14 14 126 
126 14 14 14 16 16 16 16 15 16 16 17 16 16 16 16 16 16 15 17 17 15 15 15 15 15 15 15 15 15 15 16 15 15 14 14 16 16 16 16 16 15 16 16 15 16 14 14 14 126 
126 14 14 14 16 16 16 16 16 16 16 17 17 17 17 14 14 14 17 17 17 17 17 15 15 15 15 15 16 16 15 15 16 16 14 14 14 16 16 16 16 15 16 16 15 16 14 14 14 126 
126 14 14 14 16 16 16 16 16 14 14 17 17 17 17 14 14 14 17 15 17 17 17 17 15 15 16 16 16 15 16 16 16 14 14 14 14 16 16 16 16 15 16 15 15 16 14 14 14 126 
126 14 14 14 16 16 16 16 14 14 14 17 17 17 17 17 14 14 14 17 17 17 15 17 15 16 16 16 16 16 16 16 16 14 14 14 14 16 16 16 15 16 15 15 16 16 14 14 14 126 
126 14 14 14 14 16 16 14 14 14 17 17 17 17 17 17 14 14 14 17 17 17 17 17 15 15 15 15 15 16 16 15 15 14 14 14 14 16 16 16 16 15 15 16 16 14 14 14 14 126 
126 14 14 14 14 16 14 14 16 17 17 17 17 17 15 15 17 14 14 14 17 17 17 15 16 16 16 16 16 16 16 16 14 14 14 14 16 16 16 15 15 15 16 16 16 14 14 14 14 126 
126 14 14 14 14 14 14 14 16 16 17 17 17 17 16 17 17 14 14 14 17 17 17 17 16 15 15 15 16 16 16 16 14 14 14 14 16 16 15 15 16 16 16 16 14 14 14 14 14 126 
126 14 14 14 14 14 14 16 16 16 16 17 17 17 17 17 17 17 17 17 17 17 17 17 15 15 16 16 16 16 16 16 14 14 14 14 16 16 16 16 16 16 16 14 14 14 14 14 14 126 
126 14 14 14 14 14 14 16 16 16 16 14 17 17 17 17 17 17 16 16 16 16 16 16 31 33 15 16 16 16 16 16 14 14 14 14 16 16 16 16 16 14 14 14 14 14 14 14 14 126 
126 14 14 14 14 14 14 14 14 14 14 14 14 14 14 14 14 14 14 14 14 14 14 14 78 79 14 14 14 14 14 14 14 14 14 14 14 14 14 14 14 14 14 14 14 14 14 14 14 126 
126 14 14 14 14 14 14 14 14 14 14 14 14 14 14 14 14 14 14 14 14 14 14 14 78 79 14 14 14 14 14 14 14 14 14 14 14 14 14 14 14 14 14 14 14 14 14 14 14 126 
126 14 14 14 14 14 14 14 14 14 14 14 14 14 14 14 14 14 14 14 14 14 14 14 78 79 14 14 14 14 14 14 14 14 14 14 14 14 14 14 14 14 14 14 14 14 14 14 14 126 
126 126 126 126 126 126 126 126 126 126 126 126 126 126 126 126 126 126 126 126 126 126 126 126 126 126 126 126 126 126 126 126 126 126 126 126 126 126 126 126 126 126 126 126 126 126 126 126 126 126 
