126 126 126 126 126 126 126 126 126 126 126 126 126 126 126 126 126 126 126 126 126 126 126 126 126 126 126 126 126 126 126 126 126 126 126 126 126 126 126 126 126 126 126 126 126 126 126 126 126 126 
126 14 14 14 14 14 14 14 14 14 14 14 14 14 14 14 14 14 14 14 14 14 14 14 14 14 14 14 14 14 14 14 14 14 14 14 14 14 14 14 14 14 14 14 14 14 14 14 14 126 
126 14 14 14 14 14 14 14 14 14 14 14 14 14 14 14 14 14 14 14 14 14 14 14 14 14 14 14 14 14 14 14 14 14 14 14 14 14 14 14 14 14 14 14 14 14 14 14 14 126 
126 14 14 14 14 14 14 14 14 14 14 14 14 14 14 14 14 14 14 14 14 14 14 14 14 14 14 14 14 14 14 14 14 14 14 14 14 14 14 14 14 14 14 14 14 14 14 14 14 126 
126 14 14 14 14 14 14 14 14 16 16 16 16 16 16 16 16 16 16 16 16 16 16 16 16 16 16 16 16 16 16 16 16 16 16 16 16 16 14 14 14 14 14 14 14 14 14 14 14 126 
126 14 14 14 14 14 14 14 16 16 16 16 16 16 16 16 16 16 16 16 16 16 16 16 16 16 16 16 16 16 16 16 16 16 16 16 16 16 16 16 16 16 16 16 14 14 14 14 14 126 
126 14 14 14 14 14 14 16 16 16 16 16 16 16 16 16 16 16 16 16 16 16 16 16 16 16 16 16 16 16 16 16 16 16 16 16 16 16 16 16 16 16 16 16 16 14 14 14 14 126 
126 14 14 14 14 14 16 16 16 16 16 16 16 16 16 16 16 16 15 15 15 16 16 16 16 16 16 16 16 16 16 16 16 16 16 16 16 16 16 15 15 16 16 16 16 16 14 14 14 126 
126 14 14 14 14 16 16 16 16 16 16 16 16 15 15 15 15 15 15 16 16 16 16 16 16 16 16 16 16 15 15 16 16 16 16 15 16 16 16 15 16 16 16 16 16 16 14 14 14 126 
126 14 14 14 14 16 16 16 16 16 16 15 15 15 16 16 16 16 16 16 16 16 16 16 16 15 15 16 16 16 15 15 16 16 16 15 15 16 16 15 16 16 16 16 16 16 14 14 14 126 
126 14 14 14 14 16 16 16 16 16 16 15 16 16 16 16 16 16 16 15 15 15 15 15 15 15 15 16 16 16 16 15 15 15 16 16 15 15 16 15 16 16 16 16 16 16 14 14 14 126 
126 14 14 14 14 16 16 16 16 16 15 15 16 16 16 16 16 15 15 15 16 16 16 16 16 16 15 15 16 16 16 16 16 15 15 16 16 15 15 15 16 16 16 16 16 16 14 14 14 126 
126 14 14 14 16 16 16 16 16 16 15 16 16 16 15 16 16 16 16 16 16 16 16 16 16 16 16 16 16 16 16 16 16 16 16 16 16 16 15 15 16 16 16 16 16 16 14 14 14 126 
126 14 14 14 16 16 16 16 16 16 15 16 16 16 15 16 16 16 16 42 42 42 42 42 42 42 42 42 42 42 42 42 16 16 16 16 16 16 16 15 15 16 16 16 16 16 14 14 14 126 
126 14 14 14 16 16 16 16 16 16 15 16 16 16 15 16 16 16 16 42 46 45 46 44 42 47 47 47 47 47 80 42 16 16 16 16 16 16 16 15 15 16 16 16 16 16 14 14 14 126 
126 14 14 14 16 16 16 16 16 16 15 16 16 16 15 15 16 16 16 42 47 47 81 47 42 47 47 47 47 47 47 42 16 16 16 16 16 16 16 15 15 16 16 16 16 16 14 14 14 126 
126 14 14 14 16 16 16 16 16 16 15 16 16 16 16 15 16 16 16 42 47 47 47 47 42 47 47 47 47 47 47 42 16 16 16 16 16 16 16 15 15 16 16 16 16 16 14 14 14 126 
126 14 14 14 16 16 16 16 16 16 16 16 16 16 15 15 16 16 16 42 47 47 47 47 47 47 47 47 47 47 47 42 16 16 16 15 16 16 16 15 16 16 16 16 16 16 14 14 14 126 
126 14 14 14 16 16 16 16 16 16 16 16 16 15 15 15 16 16 16 42 47 47 47 47 47 47 47 47 47 47 47 42 16 16 16 15 16 16 16 15 16 16 16 15 15 16 14 14 14 126 
126 14 14 14 16 16 16 16 16 16 16 16 15 15 16 15 16 16 16 42 42 42 42 42 42 47 42 42 42 42 42 42 16 16 16 15 16 15 15 16 16 16 16 15 16 16 14 14 14 126 
126 14 14 14 16 16 16 16 16 16 16 15 15 16 16 15 15 16 16 16 16 16 16 24 30 30 30 27 16 16 16 16 16 16 16 15 16 15 16 16 16 16 15 15 16 16 14 14 14 126 
126 14 14 14 16 16 16 16 16 16 15 15 16 16 16 15 15 15 16 16 16 16 16 24 30 30 30 30 27 16 16 16 16 16 16 16 15 15 16 16 16 16 15 16 16 16 16 14 14 126 
126 14 14 14 16 16 16 16 16 16 15 16 16 16 16 16 16 15 15 15 16 16 16 16 20 30 30 30 30 27 16 16 16 16 16 16 15 15 15 15 16 15 15 16 16 16 16 14 14 126 
126 14 14 14 16 16 16 16 16 16 16 16 16 16 16 16 16 16 16 16 15 15 16 16 16 20 30 30 30 30 27 16 16 16 16 16 15 15 15 15 15 15 16 16 16 16 16 16 14 126 
126 14 14 14 16 15 15 15 15 15 16 16 16 16 16 16 16 16 16 15 15 15 16 16 16 16 20 30 30 30 30 27 28 28 28 28 28 28 28 28 28 28 28 28 28 28 28 28 28 126 
126 14 14 14 16 15 16 16 16 15 16 16 16 16 16 15 15 15 16 15 16 15 16 16 16 16 29 30 30 30 30 30 30 30 30 30 30 30 30 30 30 30 30 30 30 30 30 30 30 126 
126 14 14 14 16 16 16 16 16 15 16 16 16 16 15 15 16 16 16 15 15 15 16 16 16 29 30 30 30 30 30 30 30 30 30 30 30 30 30 30 30 30 30 30 30 30 30 30 30 126 
126 14 14 14 16 16 16 16 16 15 16 16 16 15 15 16 16 16 16 16 16 16 16 28 29 30 30 30 18 19 19 19 19 19 19 19 19 19 19 19 19 19 19 19 19 19 19 19 19 126 
126 14 14 14 16 16 16 15 16 15 16 16 15 15 16 16 16 16 16 16 16 16 29 30 30 30 30 18 16 16 16 16 16 16 16 16 16 16 16 16 16 16 16 16 16 16 16 16 14 126 
126 14 14 14 16 16 16 15 16 15 16 15 15 16 16 16 43 43 43 43 43 29 30 30 30 30 18 16 16 16 16 16 16 16 16 16 16 16 16 16 16 16 16 16 16 16 16 16 14 126 
126 14 14 14 16 16 16 15 16 15 15 15 16 16 16 16 43 48 48 48 43 30 30 30 18 19 16 16 16 16 16 16 16 16 15 16 16 16 16 16 16 15 15 15 15 15 15 14 14 126 
126 14 14 14 14 16 16 15 16 15 15 16 16 16 16 16 43 48 48 48 48 30 30 18 16 16 16 16 16 16 16 16 15 15 15 15 16 16 16 16 16 16 16 16 16 16 16 14 14 126 
126 14 14 14 14 16 16 15 16 15 15 16 16 16 16 16 43 48 48 48 43 19 19 16 16 16 16 16 16 16 15 15 15 15 16 15 16 16 16 16 16 16 16 16 16 16 14 14 14 126 
126 14 14 14 14 16 16 15 15 15 16 16 16 16 16 16 43 48 48 48 43 16 16 16 16 16 16 16 15 15 15 16 15 15 15 15 16 16 16 16 16 16 16 16 16 14 14 14 14 126 
126 14 14 14 14 16 16 16 15 15 16 16 16 16 16 16 43 48 48 48 43 16 16 16 16 16 16 16 15 15 16 16 15 15 15 16 16 16 16 16 16 16 16 16 16 16 14 14 14 126 
126 14 14 14 16 16 16 16 15 16 16 16 16 16 16 16 43 43 43 43 43 16 16 16 16 16 16 16 16 16 16 16 16 16 16 16 16 16 16 16 16 16 16 16 16 16 14 14 14 126 
126 14 14 14 16 16 16 16 15 15 15 16 16 16 16 16 16 16 16 16 16 16 16 16 16 16 16 16 16 16 16 16 16 16 16 16 16 16 16 16 16 16 16 16 16 16 16 14 14 126 
126 14 14 14 16 16 16 16 16 15 15 16 16 16 16 16 16 16 16 16 16 16 16 16 16 16 16 16 16 16 16 16 16 16 16 16 16 16 16 16 16 16 16 16 16 16 16 14 14 126 
126 14 14 14 16 16 16 16 16 16 15 15 16 16 16 16 15 15 15 15 15 15 15 15 15 15 16 16 16 16 16 16 16 16 16 16 16 16 16 16 16 16 16 16 16 16 16 14 14 126 
126 14 14 14 16 16 16 16 16 16 16 15 15 16 15 16 16 16 16 16 16 16 16 16 16 16 16 16 16 16 16 16 16 16 16 16 16 16 16 16 16 16 16 16 16 16 16 14 14 126 
126 14 14 16 16 16 16 16 16 16 16 16 16 16 16 16 16 16 16 16 16 16 16 16 16 16 16 16 16 16 16 16 16 16 16 16 16 16 16 16 16 16 16 16 16 16 14 14 14 126 
126 14 14 14 14 16 16 16 16 16 16 16 16 16 16 16 16 16 16 16 16 16 16 16 16 16 16 16 16 16 16 16 16 16 16 16 16 16 16 16 16 16 16 16 16 16 14 14 14 126 
126 14 14 14 14 14 16 16 16 16 16 16 16 16 16 16 16 16 16 16 16 16 16 16 16 16 16 16 16 16 16 16 16 16 16 16 16 16 16 16 16 16 16 16 16 14 14 14 14 126 
126 14 14 14 14 14 14 16 16 16 16 16 16 16 16 16 16 16 16 16 16 16 16 16 16 16 16 16 16 16 16 16 16 16 16 16 16 16 16 16 16 16 16 16 14 14 14 14 14 126 
126 14 14 14 14 14 14 14 16 16 16 16 16 16 16 16 16 16 16 16 16 16 16 16 16 16 16 16 16 16 16 16 16 16 16 16 16 16 16 16 16 16 16 14 14 14 14 14 14 126 
126 14 14 14 14 14 14 14 14 16 16 16 16 16 16 16 16 16 16 16 14 14 14 14 14 14 14 14 14 14 14 14 14 14 14 14 14 14 14 14 14 14 14 14 14 14 14 14 14 126 
126 14 14 14 14 14 14 14 14 14 14 14 14 14 14 14 14 14 14 14 14 14 14 14 14 14 14 14 14 14 14 14 14 14 14 14 14 14 14 14 14 14 14 14 14 14 14 14 14 126 
126 14 14 14 14 14 14 14 14 14 14 14 14 14 14 14 14 14 14 14 14 14 14 14 14 14 14 14 14 14 14 14 14 14 14 14 14 14 14 14 14 14 14 14 14 14 14 14 14 126 
126 14 14 14 14 14 14 14 14 14 14 14 14 14 14 14 14 14 14 14 14 14 14 14 14 14 14 14 14 14 14 14 14 14 14 14 14 14 14 14 14 14 14 14 14 14 14 14 14 126 
126 126 126 126 126 126 126 126 126 126 126 126 126 126 126 126 126 126 126 126 126 126 126 126 126 126 126 126 126 126 126 126 126 126 126 126 126 126 126 126 126 126 126 126 126 126 126 126 126 126 
