126 126 126 126 126 126 126 126 126 126 126 126 126 126 126 126 126 126 126 126 126 126 126 126 126 126 126 126 126 126 126 126 126 126 126 126 126 126 126 126 126 126 126 126 126 126 126 126 126 126 
126 12 12 12 12 12 12 12 12 12 12 12 12 12 12 12 12 12 12 12 12 12 12 12 12 78 79 12 12 12 12 12 12 12 12 12 12 12 12 12 12 12 12 12 12 12 12 12 12 126 
126 12 12 12 12 12 12 12 12 12 12 12 12 12 12 12 12 12 12 12 12 12 12 12 12 78 79 12 12 12 12 12 12 12 12 12 12 12 12 12 12 12 12 12 12 12 12 12 12 126 
126 12 12 12 12 12 16 16 16 16 16 16 16 16 16 16 16 16 16 16 16 16 16 16 16 78 79 16 16 16 16 16 16 16 16 16 16 16 16 16 16 16 16 12 12 12 12 12 12 126 
126 12 12 12 16 16 16 16 16 16 16 16 16 16 16 16 16 16 16 16 16 16 16 16 16 78 79 16 16 16 16 16 16 16 16 16 16 16 16 16 16 16 16 16 16 12 12 12 12 126 
126 12 12 12 16 16 16 16 16 16 16 16 16 16 16 16 16 16 16 16 16 16 16 16 16 78 79 16 16 16 16 16 16 16 16 16 16 16 16 16 16 16 16 16 16 16 12 12 12 126 
126 12 12 16 16 16 16 16 16 16 16 16 16 16 16 16 16 16 16 16 16 16 16 16 16 78 79 16 16 16 16 16 16 16 16 16 16 16 16 16 16 16 16 16 16 16 12 12 12 126 
126 12 12 16 16 16 16 16 16 16 16 16 16 16 16 16 16 16 16 16 16 16 16 16 16 78 79 16 16 16 16 16 16 16 16 16 16 16 16 16 16 16 16 16 16 16 12 12 12 126 
126 12 12 16 16 16 16 16 16 16 16 16 16 16 16 16 16 16 16 16 16 16 16 16 16 78 79 16 16 16 16 16 16 16 16 16 16 16 16 16 16 16 16 16 16 16 16 12 12 126 
126 12 12 16 16 16 16 16 16 16 16 16 16 16 16 16 16 16 16 16 16 16 16 16 16 78 79 16 16 16 16 16 16 16 16 16 16 16 16 16 16 16 16 16 16 16 16 12 12 126 
126 12 12 16 16 16 16 16 16 16 16 16 16 16 16 16 16 16 16 16 16 16 16 16 16 78 79 16 16 16 16 16 16 16 16 16 16 16 16 16 16 16 16 16 16 16 16 12 12 126 
126 12 12 12 16 16 16 16 16 16 16 16 16 16 16 16 16 16 16 16 16 16 16 16 16 78 79 16 16 16 16 16 16 16 43 43 43 43 43 43 43 16 16 16 16 16 16 12 12 126 
126 12 12 12 16 16 16 16 16 16 16 16 16 16 16 16 16 16 16 16 16 16 16 16 16 78 79 16 16 16 16 16 16 43 45 44 46 45 44 45 46 43 16 16 16 16 16 12 12 126 
126 12 12 12 16 16 16 16 16 16 16 16 16 16 16 16 16 16 16 16 16 16 16 16 16 78 79 16 16 16 16 16 43 48 48 49 48 48 48 49 48 48 43 16 16 16 16 12 12 126 
126 12 12 16 16 16 16 16 16 16 16 16 16 16 16 16 16 16 16 16 16 16 16 16 16 78 79 16 16 16 16 16 43 48 48 48 48 50 48 48 48 48 43 16 16 16 16 12 12 126 
126 12 12 16 16 16 16 16 16 16 16 16 16 16 16 16 16 16 16 16 16 16 16 16 16 78 79 16 16 16 16 16 43 48 83 84 48 48 48 83 84 48 43 16 16 16 16 12 12 126 
126 12 12 16 16 16 16 16 41 41 41 41 41 41 41 41 41 41 41 41 16 16 16 16 16 78 79 16 16 16 16 16 43 48 48 48 48 47 48 48 48 48 43 16 16 16 16 12 12 126 
126 12 12 16 16 16 16 16 41 47 47 47 103 105 109 110 47 113 114 41 16 16 16 16 16 78 79 16 16 16 16 16 43 48 83 84 47 47 47 83 84 48 43 16 16 16 16 12 12 126 
126 12 12 16 16 16 16 16 41 101 101 101 102 104 111 112 108 115 116 41 16 16 16 16 16 78 79 16 16 16 16 16 43 48 48 48 48 47 48 48 48 48 43 16 16 16 16 12 12 126 
126 12 12 16 16 16 16 16 41 47 47 47 47 117 118 119 47 47 47 41 16 16 16 16 16 78 79 16 16 16 16 16 43 48 83 84 48 47 48 83 84 48 43 16 16 16 16 12 12 126 
126 12 12 16 16 16 16 16 41 106 47 47 47 120 121 122 47 47 47 41 16 16 16 16 16 78 79 16 16 16 16 16 43 48 48 48 48 48 48 48 48 48 43 16 16 16 16 12 12 126 
126 12 12 16 16 16 16 16 41 107 107 47 47 123 124 125 47 47 106 41 16 16 16 16 16 78 79 16 16 16 16 16 43 43 43 43 48 48 48 43 43 43 43 16 16 16 16 12 12 126 
126 12 12 16 16 16 16 16 41 41 41 41 41 41 41 41 47 47 41 41 16 16 12 31 32 37 36 32 33 12 16 16 16 16 16 16 78 30 79 16 16 16 16 16 16 16 16 12 12 126 
126 12 12 16 16 16 16 16 16 16 16 16 16 16 16 15 78 79 16 16 16 16 31 37 30 30 30 30 36 33 16 16 16 16 16 16 78 30 79 16 16 16 16 16 16 16 16 12 12 126 
126 12 12 16 16 16 16 16 16 16 16 16 16 16 16 16 78 79 16 16 16 16 78 30 85 86 87 88 30 79 16 16 16 16 16 16 78 30 79 16 16 16 16 16 16 16 16 12 14 126 
126 32 32 32 32 32 32 32 32 32 32 32 32 32 32 32 37 36 32 32 32 32 37 30 89 90 91 92 30 36 32 32 32 32 32 32 37 30 36 32 32 32 32 32 32 32 32 32 32 126 
126 39 39 39 39 39 39 39 39 39 39 39 39 39 39 39 39 39 39 39 39 39 35 30 93 94 95 96 30 34 39 39 39 39 39 39 39 39 39 39 39 39 39 39 39 39 39 39 39 126 
126 12 12 16 16 16 16 16 16 16 16 16 16 16 16 16 16 16 16 16 16 16 78 30 97 98 99 100 30 79 16 16 16 16 16 16 16 16 16 16 16 16 16 16 16 16 16 12 12 126 
126 12 12 16 16 16 16 16 16 16 16 16 16 16 16 16 16 16 16 16 16 16 38 35 30 30 30 30 34 40 16 16 16 16 16 16 16 16 16 16 16 16 16 16 16 16 16 12 12 126 
126 12 12 16 16 16 16 16 16 16 16 16 16 16 16 16 16 16 16 16 16 16 12 38 39 35 34 39 40 12 16 16 16 16 16 16 16 16 16 16 16 16 16 16 16 16 16 12 12 126 
126 12 12 16 16 16 16 16 16 16 16 16 16 16 16 16 16 16 16 16 16 16 16 16 16 78 79 16 16 43 43 43 43 43 43 43 43 43 16 16 16 16 16 16 16 16 16 12 12 126 
126 12 12 16 16 16 16 16 16 16 16 16 16 16 16 16 16 16 16 16 16 16 16 16 16 78 79 16 16 43 45 44 46 45 44 45 44 43 16 16 16 16 16 16 16 16 16 12 12 126 
126 12 12 16 16 16 16 16 16 16 16 16 16 16 16 16 16 16 16 16 16 16 16 16 16 78 36 32 32 47 47 47 47 47 47 47 45 43 16 16 16 16 16 16 16 16 16 12 12 126 
126 12 12 16 16 16 16 16 16 16 16 16 16 16 16 16 16 16 16 16 16 16 16 16 16 78 34 39 39 47 47 47 47 47 47 47 46 43 16 16 16 16 16 16 16 16 16 12 12 126 
126 12 12 16 16 16 16 16 16 16 16 16 16 16 16 16 16 16 16 16 16 16 16 16 16 78 79 17 17 43 47 47 47 47 47 47 44 43 16 16 16 16 16 16 16 16 16 12 12 126 
126 12 12 16 16 16 16 16 16 16 16 16 16 16 16 16 16 16 16 16 16 16 16 16 16 78 79 16 16 43 43 43 43 43 43 43 43 43 16 16 16 16 16 16 16 16 16 12 12 126 
126 12 12 16 16 16 16 16 16 16 16 16 16 16 16 16 16 16 16 16 16 16 16 16 16 78 79 16 16 16 16 16 16 16 16 16 16 16 16 16 16 16 16 16 16 16 16 12 12 126 
126 12 12 16 16 16 16 16 16 16 16 16 16 16 16 16 16 16 16 16 16 16 16 16 16 78 79 16 16 16 16 16 16 16 16 16 16 16 16 16 16 16 16 16 16 16 16 12 12 126 
126 12 12 16 16 16 16 16 16 16 16 16 16 16 16 16 16 16 16 16 16 16 16 16 16 78 79 16 16 16 16 16 16 16 16 16 16 16 16 16 16 16 16 16 16 16 16 12 12 126 
126 12 12 16 16 16 16 16 16 16 16 16 16 16 16 16 16 16 16 16 16 16 16 16 16 78 79 16 16 16 16 16 16 16 16 16 16 16 16 16 16 16 16 16 16 16 16 12 12 126 
126 12 12 16 16 16 16 16 16 16 16 16 16 16 16 16 16 16 16 16 16 16 16 16 16 78 79 16 16 16 16 16 16 16 16 16 16 16 16 16 16 16 16 16 16 16 16 12 12 126 
126 12 12 16 16 16 16 16 16 16 16 16 16 16 16 16 16 16 16 16 16 16 16 16 16 78 79 16 16 16 16 16 16 16 16 16 16 16 16 16 16 16 16 16 16 16 16 12 12 126 
126 12 12 12 16 16 16 16 16 16 16 16 16 16 16 16 16 16 16 16 16 16 16 16 16 78 79 16 16 16 16 16 16 16 16 16 16 16 16 16 16 16 16 16 16 16 16 12 12 126 
126 12 12 12 16 16 16 16 16 16 16 16 16 16 16 16 16 16 16 16 16 16 16 16 16 78 79 16 16 16 16 16 16 16 16 16 16 16 16 16 16 16 16 16 16 16 16 12 12 126 
126 12 12 12 16 16 16 16 16 16 16 16 16 16 16 16 16 16 16 16 16 16 16 16 16 78 79 16 16 16 16 16 16 16 16 16 16 16 16 16 16 16 16 16 16 16 16 12 12 126 
126 12 12 12 12 16 16 16 16 16 16 16 16 16 16 16 16 16 16 16 16 16 16 16 16 78 79 16 16 16 16 16 16 16 16 16 16 16 16 16 16 16 16 16 16 16 12 12 12 126 
126 12 12 12 12 12 16 16 16 16 16 16 16 16 16 16 16 16 16 16 16 16 16 16 16 78 79 16 16 16 16 16 16 16 16 16 16 16 16 16 16 16 16 16 12 12 12 12 12 126 
126 12 12 12 12 12 12 12 12 12 12 12 12 12 12 12 12 12 12 12 12 12 12 12 12 78 79 12 12 12 12 12 12 12 12 12 12 12 12 12 12 12 12 12 12 12 12 12 12 126 
126 12 12 12 12 12 12 12 12 12 12 12 12 12 12 12 12 12 12 12 12 12 12 12 12 78 79 12 12 12 12 12 12 12 12 12 12 12 12 12 12 12 12 12 12 12 12 12 12 126 
126 126 126 126 126 126 126 126 126 126 126 126 126 126 126 126 126 126 126 126 126 126 126 126 126 126 126 126 126 126 126 126 126 126 126 126 126 126 126 126 126 126 126 126 126 126 126 126 126 126 
